/**                                                     **       **                              **          **                 
/**                                  *****             /**      //                              /**         /**                 
/**        /******  **   ** *******  **///**  *****     /**       ** ******  ******   ******     /**         /**  *****  **    **
/**       **////**/**  /**//**///**/**  /** **///**    /**      /**////**  //////** //**//*  ******      ****** **///**/**   /**
/**      /**   /**/**  /** /**  /**//******/*******    /**      /**   **    *******  /** /  **///**     **///**/*******//** /** 
/**      /**   /**/**  /** /**  /** /////**/**////     /**      /**  **    **////**  /**   /**  /**    /**  /**/**////  //****  
/********//****** //****** ***  /**  ***** //******    /********/** ******//********/***   //******    //******//******  //**   
////////  //////   ////// ///   //  /////   //////     //////// // //////  //////// ///     //////      //////  //////    //    